NO ./textures/new/NO.png
SO ./textures/new/SO.png
WE ./textures/new/WE.png
EA ./textures/new/EA.png

F 22,100,0
C 225,30,0

111111
10N001
111111