NO ./textures/NO.png
SO ./textures/SO.png
WE ./textures/WE.png
EA ./textures/EA.png
F 220,100,0
C 225,30,0
1111111
1000001
110S001
1001001
1111111