NO ./textures/NO.png
SO ./textures/SO.png
WE ./textures/WE.png
EA ./textures/EA.png

F 220,100,0
C 225,30,0

1111111111111111111
1000000000000000001
1000000K00000000001
10000000000000000S1
1111111111111111111
